#####################
#s                  #
#                   #
#                   #
#                   #
#                   #
#                   #
#                   #
#                   #
#                   #
#                   #
#                   #
#                   #
#                   #
#                   #
#                   #
#                   #
#                   #
#                   #
#                   #
#                  f#
#####################